11111111111111
1PC0001001C111
1111C0000001E1
1P0000000C0001
11111111111111